#########################################
#   #         #     #       #   #       #
# ### # ##### # ### # ##### # # # ##### #
#   # # #       # #   #   #   # #     # #
# # # # ######### ####### ##### # ### # #
# #   #     #   #   #         # # #   # #
# ######### # ### # # # ####### # # #####
# #         #   # #   #       # # #     #
# # ######### # # ####### ### # # ##### #
# #   #       #   # #   # # #   #     # #
# ### ### ##### ### # # # # ########### #
# # #   # #   #     # # # #           # #
# # ### ### # ######### # ##### ##### # #
# #   #     # #         # #   #   #   # #
# ### ####### # ######### # # ### # ### #
#   #     #   #       # # # #     #   # #
### ### # # ######### # # # ######### # #
#   #   # #         # # #   #     #   # #
# ### ### ####### ### # ##### # ### ### #
#     #         #     #       #         #
#########################################
